"a" = (/turf/unsimulated/ground/grass,/area/space)
"d" = (/obj/structure/platform{dir = 1},/turf/unsimulated/floor/river/deep{icon_state = "water"},/area/space)
"e" = (/turf/unsimulated/floor/road{dir = 8},/area/space)
"i" = (/turf/unsimulated/floor/road{icon_state = "sidewalkconcrete"},/area/space)
"m" = (/turf/unsimulated/floor/road{dir = 1; icon_state = "sidewalk_corner_road"},/area/space)
"t" = (/obj/structure/platform,/obj/structure/railing,/turf/unsimulated/floor/river/deep{icon_state = "water"},/area/space)
"u" = (/turf/unsimulated/floor/road{dir = 8; icon_state = "sidewalk_corner_road"},/area/space)
"w" = (/obj/structure/railing,/turf/unsimulated/floor/road{icon_state = "sidewalkconcrete"},/area/space)
"x" = (/turf/unsimulated/floor/road{icon_state = "sidewalk_corner_road"},/area/space)
"N" = (/turf/unsimulated/floor/river/deep{icon_state = "water"},/area/space)
"Q" = (/turf/unsimulated/floor/road{dir = 8; icon_state = "roaddottedstripescross"},/area/space)
"R" = (/turf/unsimulated/floor/road{dir = 4; icon_state = "sidewalk_corner_road"},/area/space)
"V" = (/turf/unsimulated/ground/grass,/area/coldwar/warpactfob)
"W" = (/turf/unsimulated/floor/road{icon_state = "concreteroad"; temperature = 293.15},/area/space)
"Y" = (/turf/unsimulated/ground/grass,/area/coldwar/usmcfob)

(1,1,1) = {"
aaaaaaaaaaaaaaaaaaaaaaaaaaaaaaaaaaaaWWaWWiNNNNNNNNNNNNNNNNNNNNiWWaWWaaaaaaaaaaaaaaaaaaaaaaaaaaaaaaaa
aaaaaaaaaaaaaaaaaaaaaaaaaaaaaaaaaaaaWWaWWiNNNNNNNNNNNNNNNNNNNNiWWaWWaaaaaaaaaaaaaaaaaaaaaaaaaaaaaaaa
aaaaaaaaaaaaaaaaaaaaaaaaaaaaaaaaaaaaWWaWWiNNNNNNNNNNNNNNNNNNNNiWWaWWaaaaaaaaaaaaaaaVVVVVVVVVVVVVVVaa
aaaaaaaaaaaaaaaaaaaaaaaaaaaaaaaaaaaaWWaWWiNNNNNNNNNNNNNNNNNNNNiWWaWWaaaaaaaaaaaaaaaVVVVVVVVVVVVVVVaa
aaaaaaaaaaaaaaaaaaaaaaaaaaaaaaaaaaaaWWaWWiNNNNNNNNNNNNNNNNNNNNiWWaWWaaaaaaaaaaaaaaaVVVVVVVVVVVVVVVaa
aaaaaaaaaaaaaaaaaaaaaaaaaaaaaaaaaaaaWWaWWiNNNNNNNNNNNNNNNNNNNNiWWaWWaaaaaaaaaaaaaaaVVVVVVVVVVVVVVVaa
aaaaaaaaaaaaaaaaaaaaaaaaaaaaaaaaaaaaWWaWWiNNNNNNNNNNNNNNNNNNNNiWWaWWaaaaaaaaaaaaaaaVVVVVVVVVVVVVVVaa
aaaaaaaaaaaaaaaaaaaaaaaaaaaaaaaaaaaaWWaWWiNNNNNNNNNNNNNNNNNNNNiWWaWWaaaaaaaaaaaaaaaVVVVVVVVVVVVVVVaa
aaaaaaaaaaaaaaaaaaaaaaaaaaaaaaaaaaaaWWaWWiNNNNNNNNNNNNNNNNNNNNiWWaWWaaaaaaaaaaaaaaaVVVVVVVVVVVVVVVaa
aaaaaaaaaaaaaaaaaaaaaaaaaaaaaaaaaaaaWWaWWiNNNNNNNNNNNNNNNNNNNNiWWaWWaaaaaaaaaaaaaaaVVVVVVVVVVVVVVVaa
aaaaaaaaaaaaaaaaaaaaaaaaaaaaaaaaaaaaWWaWWiNNNNNNNNNNNNNNNNNNNNiWWaWWaaaaaaaaaaaaaaaVVVVVVVVVVVVVVVaa
aaaaaaaaaaaaaaaaaaaaaaaaaaaaaaaaaaaaWWaWWiNNNNNNNNNNNNNNNNNNNNiWWaWWaaaaaaaaaaaaaaaVVVVVVVVVVVVVVVaa
aaaaaaaaaaaaaaaaaaaaaaaaaaaaaaaaaaaaWWaWWiNNNNNNNNNNNNNNNNNNNNiWWaWWaaaaaaaaaaaaaaaVVVVVVVVVVVVVVVaa
aaaaaaaaaaaaaaaaaaaaaaaaaaaaaaaaaaaaWWaWWiNNNNNNNNNNNNNNNNNNNNiWWaWWaaaaaaaaaaaaaaaVVVVVVVVVVVVVVVaa
aaaaaaaaaaaaaaaaaaaaaaaaaaaaaaaaaaaaWWaWWiNNNNNNNNNNNNNNNNNNNNiWWaWWaaaaaaaaaaaaaaaVVVVVVVVVVVVVVVaa
aaaaaaaaaaaaaaaaaaaaaaaaaaaaaaaaaaaaWWaWWiNNNNNNNNNNNNNNNNNNNNiWWaWWaaaaaaaaaaaaaaaVVVVVVVVVVVVVVVaa
aaaaaaaaaaaaaaaaaaaaaaaaaaaaaaaaaaaaWWaWWiNNNNNNNNNNNNNNNNNNNNiWWaWWaaaaaaaaaaaaaaaVVVVVVVVVVVVVVVaa
aaaaaaaaaaaaaaaaaaaaaaaaaaaaaaaaaaaaWWaWWiNNNNNNNNNNNNNNNNNNNNiWWaWWaaaaaaaaaaaaaaaaaaaaaaaaaaaaaaaa
aaaaaaaaaaaaaaaaaaaaaaaaaaaaaaaaaaaaWWaWWiNNNNNNNNNNNNNNNNNNNNiWWaWWaaaaaaaaaaaaaaaaaaaaaaaaaaaaaaaa
aaaaaaaaaaaaaaaaaaaaaaaaaaaaaaaaaaaaWWaWWiNNNNNNNNNNNNNNNNNNNNiWWaWWaaaaaaaaaaaaaaaaaaaaaaaaaaaaaaaa
aaaaaaaaaaaaaaaaaaaaaaaaaaaaaaaaaaaaWWaWWiNNNNNNNNNNNNNNNNNNNNiWWaWWaaaaaaaaaaaaaaaaaaaaaaaaaaaaaaaa
aaaaaaaaaaaaaaaaaaaaaaaaaaaaaaaaaaaaWWaWWiNNNNNNNNNNNNNNNNNNNNiWWaWWaaaaaaaaaaaaaaaaaaaaaaaaaaaaaaaa
aaaaaaaaaaaaaaaaaaaaaaaaaaaaaaaaaaaaWWaWWiNNNNNNNNNNNNNNNNNNNNiWWaWWaaaaaaaaaaaaaaaaaaaaaaaaaaaaaaaa
aaaaaaaaaaaaaaaaaaaaaaaaaaaaaaaaaaaaWWaWWiNNNNNNNNNNNNNNNNNNNNiWWaWWaaaaaaaaaaaaaaaaaaaaaaaaaaaaaaaa
aaaaaaaaaaaaaaaaaaaaaaaaaaaaaaaaaaaaWWaWWiNNNNNNNNNNNNNNNNNNNNiWWaWWaaaaaaaaaaaaaaaaaaaaaaaaaaaaaaaa
aaaaaaaaaaaaaaaaaaaaaaaaaaaaaaaaaaaaWWaWWiNNNNNNNNNNNNNNNNNNNNiWWaWWaaaaaaaaaaaaaaaaaaaaaaaaaaaaaaaa
aaaaaaaaaaaaaaaaaaaaaaaaaaaaaaaaaaaaWWaWWiNNNNNNNNNNNNNNNNNNNNiWWaWWaaaaaaaaaaaaaaaaaaaaaaaaaaaaaaaa
aaaaaaaaaaaaaaaaaaaaaaaaaaaaaaaaaaaaWWaWWiNNNNNNNNNNNNNNNNNNNNiWWaWWaaaaaaaaaaaaaaaaaaaaaaaaaaaaaaaa
aaaaaaaaaaaaaaaaaaaaaaaaaaaaaaaaaaaaWWaWWiNNNNNNNNNNNNNNNNNNNNiWWaWWaaaaaaaaaaaaaaaaaaaaaaaaaaaaaaaa
aaaaaaaaaaaaaaaaaaaaaaaaaaaaaaaaaaaaWWaWWiNNNNNNNNNNNNNNNNNNNNiWWaWWaaaaaaaaaaaaaaaaaaaaaaaaaaaaaaaa
aaaaaaaaaaaaaaaaaaaaaaaaaaaaaaaaaaaaWWaWWiNNNNNNNNNNNNNNNNNNNNiWWaWWaaaaaaaaaaaaaaaaaaaaaaaaaaaaaaaa
aaaaaaaaaaaaaaaaaaaaaaaaaaaaaaaaaaaaWWaWWiNNNNNNNNNNNNNNNNNNNNiWWaWWaaaaaaaaaaaaaaaaaaaaaaaaaaaaaaaa
aaaaaaaaaaaaaaaaaaaaaaaaaaaaaaaaaaaaWWaWWiNNNNNNNNNNNNNNNNNNNNiWWaWWaaaaaaaaaaaaaaaaaaaaaaaaaaaaaaaa
aaaaaaaaaaaaaaaaaaaaaaaaaaaaaaaaaaaaWWaWWiNNNNNNNNNNNNNNNNNNNNiWWaWWaaaaaaaaaaaaaaaaaaaaaaaaaaaaaaaa
aaaaaaaaaaaaaaaaaaaaaaaaaaaaaaaaaaaaWWaWWiNNNNNNNNNNNNNNNNNNNNiWWaWWaaaaaaaaaaaaaaaaaaaaaaaaaaaaaaaa
aaaaaaaaaaaaaaaaaaaaaaaaaaaaaaaaaaaaWWaWWiNNNNNNNNNNNNNNNNNNNNiWWaWWaaaaaaaaaaaaaaaaaaaaaaaaaaaaaaaa
aaaaaaaaaaaaaaaaaaaaaaaaaaaaaaaaaaaaWWaWWiNNNNNNNNNNNNNNNNNNNNiWWaWWaaaaaaaaaaaaaaaaaaaaaaaaaaaaaaaa
aaaaaaaaaaaaaaaaaaaaaaaaaaaaaaaaaaaaWWaWWiNNNNNNNNNNNNNNNNNNNNiWWaWWaaaaaaaaaaaaaaaaaaaaaaaaaaaaaaaa
aaaaaaaaaaaaaaaaaaaaaaaaaaaaaaaaaaaaWWaWWiNNNNNNNNNNNNNNNNNNNNiWWaWWaaaaaaaaaaaaaaaaaaaaaaaaaaaaaaaa
aaaaaaaaaaaaaaaaaaaaaaaaaaaaaaaaaaaaWWaWWiNNNNNNNNNNNNNNNNNNNNiWWaWWaaaaaaaaaaaaaaaaaaaaaaaaaaaaaaaa
aaaaaaaaaaaaaaaaaaaaaaaaaaaaaaaaaaaaWWaWWiNNNNNNNNNNNNNNNNNNNNiWWaWWaaaaaaaaaaaaaaaaaaaaaaaaaaaaaaaa
aaaaaaaaaaaaaaaaaaaaaaaaaaaaaaaaaaaaWWaWWiNNNNNNNNNNNNNNNNNNNNiWWaWWaaaaaaaaaaaaaaaaaaaaaaaaaaaaaaaa
aaaaaaaaaaaaaaaaaaaaaaaaaaaaaaaaaaaaWWaWWiNNNNNNNNNNNNNNNNNNNNiWWaWWaaaaaaaaaaaaaaaaaaaaaaaaaaaaaaaa
aaaaaaaaaaaaaaaaaaaaaaaaaaaaaaaaaaaaWWaWWiNNNNNNNNNNNNNNNNNNNNiWWaWWaaaaaaaaaaaaaaaaaaaaaaaaaaaaaaaa
aaaaaaaaaaaaaaaaaaaaaaaaaaaaaaaaaaaaWWaWWiNNNNNNNNNNNNNNNNNNNNiWWaWWaaaaaaaaaaaaaaaaaaaaaaaaaaaaaaaa
aaaaaaaaaaaaaaaaaaaaaaaaaaaaaaaaaaaaWWaWWiNNNNNNNNNNNNNNNNNNNNiWWaWWaaaaaaaaaaaaaaaaaaaaaaaaaaaaaaaa
aaaaaaaaaaaaaaaaaaaaaaaaaaaaaaaaaaaaWWaWWiNNNNNNNNNNNNNNNNNNNNiWWaWWaaaaaaaaaaaaaaaaaaaaaaaaaaaaaaaa
aaaaaaaaaaaaaaaaaaaaaaaaaaaaaaaaaaaaWWaWWiNNNNNNNNNNNNNNNNNNNNiWWaWWaaaaaaaaaaaaaaaaaaaaaaaaaaaaaaaa
aaaaaaaaaaaaaaaaaaaaaaaaaaaaaaaaaaaaWWaWWiNNNNNNNNNNNNNNNNNNNNiWWaWWaaaaaaaaaaaaaaaaaaaaaaaaaaaaaaaa
aaaaaaaaaaaaaaaaaaaaaaaaaaaaaaaaaaaaWWaWWiNNNNNNNNNNNNNNNNNNNNiWWaWWaaaaaaaaaaaaaaaaaaaaaaaaaaaaaaaa
aaaaaaaaaaaaaaaaaaaaaaaaaaaaaaaaaaaaWWaWWiNNNNNNNNNNNNNNNNNNNNiWWaWWaaaaaaaaaaaaaaaaaaaaaaaaaaaaaaaa
aaaaaaaaaaaaaaaaaaaaaaaaaaaaaaaaaaaaWWaWWiNNNNNNNNNNNNNNNNNNNNiWWaWWaaaaaaaaaaaaaaaaaaaaaaaaaaaaaaaa
aaaaaaaaaaaaaaaaaaaaaaaaaaaaaaaaaaaaWWaWWiNNNNNNNNNNNNNNNNNNNNiWWaWWaaaaaaaaaaaaaaaaaaaaaaaaaaaaaaaa
aaaaaaaaaaaaaaaaaaaaaaaaaaaaaaaaaaaaWWaWWiNNNNNNNNNNNNNNNNNNNNiWWaWWaaaaaaaaaaaaaaaaaaaaaaaaaaaaaaaa
aaaaaaaaaaaaaaaaaaaaaaaaaaaaaaaaaaaaWWaWWiNNNNNNNNNNNNNNNNNNNNiWWaWWaaaaaaaaaaaaaaaaaaaaaaaaaaaaaaaa
aaaaaaaaaaaaaaaaaaaaaaaaaaaaaaaaaaaaWWaWWiNNNNNNNNNNNNNNNNNNNNiWWaWWaaaaaaaaaaaaaaaaaaaaaaaaaaaaaaaa
aaaaaaaaaaaaaaaaaaaaaaaaaaaaaaaaaaaaWWaWWiNNNNNNNNNNNNNNNNNNNNiWWaWWaaaaaaaaaaaaaaaaaaaaaaaaaaaaaaaa
aaaaaaaaaaaaaaaaaaaaaaaaaaaaaaaaaaaaWWaWWiNNNNNNNNNNNNNNNNNNNNiWWaWWaaaaaaaaaaaaaaaaaaaaaaaaaaaaaaaa
aaaaaaaaaaaaaaaaaaaaaaaaaaaaaaaaaaaaWWaWWiNNNNNNNNNNNNNNNNNNNNiWWaWWaaaaaaaaaaaaaaaaaaaaaaaaaaaaaaaa
aaaaaaaaaaaaaaaaaaaaaaaaaaaaaaaaaaaaWWaWWiNNNNNNNNNNNNNNNNNNNNiWWaWWaaaaaaaaaaaaaaaaaaaaaaaaaaaaaaaa
aaaaaaaaaaaaaaaaaaaaaaaaaaaaaaaaaaaaWWaWWiNNNNNNNNNNNNNNNNNNNNiWWaWWaaaaaaaaaaaaaaaaaaaaaaaaaaaaaaaa
aaaaaaaaaaaaaaaaaaaaaaaaaaaaaaaaaaaaWWaWWiNNNNNNNNNNNNNNNNNNNNiWWaWWaaaaaaaaaaaaaaaaaaaaaaaaaaaaaaaa
aaaaaaaaaaaaaaaaaaaaaaaaaaaaaaaaaaaaWWaWWiNNNNNNNNNNNNNNNNNNNNiWWaWWaaaaaaaaaaaaaaaaaaaaaaaaaaaaaaaa
aaaaaaaaaaaaaaaaaaaaaaaaaaaaaaaaaaaaWWaWWiNNNNNNNNNNNNNNNNNNNNiWWaWWaaaaaaaaaaaaaaaaaaaaaaaaaaaaaaaa
aaaaaaaaaaaaaaaaaaaaaaaaaaaaaaaaaaaaWWaWWiNNNNNNNNNNNNNNNNNNNNiWWaWWaaaaaaaaaaaaaaaaaaaaaaaaaaaaaaaa
aaaaaaaaaaaaaaaaaaaaaaaaaaaaaaaaaaaaWWaWWiNNNNNNNNNNNNNNNNNNNNiWWaWWaaaaaaaaaaaaaaaaaaaaaaaaaaaaaaaa
aaaaaaaaaaaaaaaaaaaaaaaaaaaaaaaaaaaaWWaWWiNNNNNNNNNNNNNNNNNNNNiWWaWWaaaaaaaaaaaaaaaaaaaaaaaaaaaaaaaa
aaaaaaaaaaaaaaaaaaaaaaaaaaaaaaaaaaaaWWaWWiNNNNNNNNNNNNNNNNNNNNiWWaWWaaaaaaaaaaaaaaaaaaaaaaaaaaaaaaaa
aaaaaaaaaaaaaaaaaaaaaaaaaaaaaaaaaaaaWWaWWiNNNNNNNNNNNNNNNNNNNNiWWaWWaaaaaaaaaaaaaaaaaaaaaaaaaaaaaaaa
aaaaaaaaaaaaaaaaaaaaaaaaaaaaaaaaaaaaWWaWWiNNNNNNNNNNNNNNNNNNNNiWWaWWaaaaaaaaaaaaaaaaaaaaaaaaaaaaaaaa
aaaaaaaaaaaaaaaaaaaaaaaaaaaaaaaaaaaaWWaWWiNNNNNNNNNNNNNNNNNNNNiWWaWWaaaaaaaaaaaaaaaaaaaaaaaaaaaaaaaa
aaaaaaaaaaaaaaaaaaaaaaaaaaaaaaaaaaaaWWaWWiNNNNNNNNNNNNNNNNNNNNiWWaWWaaaaaaaaaaaaaaaaaaaaaaaaaaaaaaaa
aaaaaaaaaaaaaaaaaaaaaaaaaaaaaaaaaaaaWWaWWiNNNNNNNNNNNNNNNNNNNNiWWaWWaaaaaaaaaaaaaaaaaaaaaaaaaaaaaaaa
aaaaaaaaaaaaaaaaaaaaaaaaaaaaaaaaaaaaWWaWWiNNNNNNNNNNNNNNNNNNNNiWWaWWaaaaaaaaaaaaaaaaaaaaaaaaaaaaaaaa
aaaaaaaaaaaaaaaaaaaaaaaaaaaaaaaaaaaaWWaWWiNNNNNNNNNNNNNNNNNNNNiWWaWWaaaaaaaaaaaaaaaaaaaaaaaaaaaaaaaa
aaaaaaaaaaaaaaaaaaaaaaaaaaaaaaaaaaaaWWaWWiNNNNNNNNNNNNNNNNNNNNiWWaWWaaaaaaaaaaaaaaaaaaaaaaaaaaaaaaaa
aaaaaaaaaaaaaaaaaaaaaaaaaaaaaaaaaaaaWWaWWiNNNNNNNNNNNNNNNNNNNNiWWaWWaaaaaaaaaaaaaaaaaaaaaaaaaaaaaaaa
aaaaaaaaaaaaaaaaaaaaaaaaaaaaaaaaaaaaWWaWWiNNNNNNNNNNNNNNNNNNNNiWWaWWaaaaaaaaaaaaaaaaaaaaaaaaaaaaaaaa
aaaaaaaaaaaaaaaaaaaaaaaaaaaaaaaaaaaaWWaWWiNNNNNNNNNNNNNNNNNNNNiWWaWWaaaaaaaaaaaaaaaaaaaaaaaaaaaaaaaa
aaaaaaaaaaaaaaaaaaaaaaaaaaaaaaaaaaaaWWaWWittttttttttttttttttttiWWaWWaaaaaaaaaaaaaaaaaaaaaaaaaaaaaaaa
aaaaaaaaaaaaaaaaaaaaaaaaaaaaaaaaaaaaWWaWWuiiiiiiiiiiiiiiiiiiiimWWaWWaaaaaaaaaaaaaaaaaaaaaaaaaaaaaaaa
aaaaaaaaaaaaaaaaaaaaaaaaaaaaaaaaaaaaWWaWWWWWWWWWWWWWWWWWWWWWWWWWWaWWaaaaaaaaaaaaaaaaaaaaaaaaaaaaaaaa
aaaaaaaaaaaaaaaaaaaaaaaaaaaaaaaaaaaaWWaWWWWWWWWWWWWWWWWWWWWWWWWWWaWWaaaaaaaaaaaaaaaaaaaaaaaaaaaaaaaa
aYYYYYYYYYYYYYYYYYYaaaaaaaaaaaaaaaaaeeQeeeeeeeeeeeeeeeeeeeeeeeeeeaeeaaaaaaaaaaaaaaaaaaaaaaaaaaaaaaaa
aYYYYYYYYYYYYYYYYYYaaaaaaaaaaaaaaaaaWWaWWWWWWWWWWWWWWWWWWWWWWWWWWaWWaaaaaaaaaaaaaaaaaaaaaaaaaaaaaaaa
aYYYYYYYYYYYYYYYYYYaaaaaaaaaaaaaaaaaWWaWWWWWWWWWWWWWWWWWWWWWWWWWWaWWaaaaaaaaaaaaaaaaaaaaaaaaaaaaaaaa
aYYYYYYYYYYYYYYYYYYaaaaaaaaaaaaaaaaaWWaWWRwwwwwwwwwwwwwwwwwwwwxWWaWWaaaaaaaaaaaaaaaaaaaaaaaaaaaaaaaa
aYYYYYYYYYYYYYYYYYYaaaaaaaaaaaaaaaaaWWaWWiddddddddddddddddddddiWWaWWaaaaaaaaaaaaaaaaaaaaaaaaaaaaaaaa
aYYYYYYYYYYYYYYYYYYaaaaaaaaaaaaaaaaaWWaWWiNNNNNNNNNNNNNNNNNNNNiWWaWWaaaaaaaaaaaaaaaaaaaaaaaaaaaaaaaa
aYYYYYYYYYYYYYYYYYYaaaaaaaaaaaaaaaaaWWaWWiNNNNNNNNNNNNNNNNNNNNiWWaWWaaaaaaaaaaaaaaaaaaaaaaaaaaaaaaaa
aYYYYYYYYYYYYYYYYYYaaaaaaaaaaaaaaaaaWWaWWiNNNNNNNNNNNNNNNNNNNNiWWaWWaaaaaaaaaaaaaaaaaaaaaaaaaaaaaaaa
aYYYYYYYYYYYYYYYYYYaaaaaaaaaaaaaaaaaWWaWWiNNNNNNNNNNNNNNNNNNNNiWWaWWaaaaaaaaaaaaaaaaaaaaaaaaaaaaaaaa
aYYYYYYYYYYYYYYYYYYaaaaaaaaaaaaaaaaaWWaWWiNNNNNNNNNNNNNNNNNNNNiWWaWWaaaaaaaaaaaaaaaaaaaaaaaaaaaaaaaa
aYYYYYYYYYYYYYYYYYYaaaaaaaaaaaaaaaaaWWaWWiNNNNNNNNNNNNNNNNNNNNiWWaWWaaaaaaaaaaaaaaaaaaaaaaaaaaaaaaaa
aYYYYYYYYYYYYYYYYYYaaaaaaaaaaaaaaaaaWWaWWiNNNNNNNNNNNNNNNNNNNNiWWaWWaaaaaaaaaaaaaaaaaaaaaaaaaaaaaaaa
aYYYYYYYYYYYYYYYYYYaaaaaaaaaaaaaaaaaWWaWWiNNNNNNNNNNNNNNNNNNNNiWWaWWaaaaaaaaaaaaaaaaaaaaaaaaaaaaaaaa
aYYYYYYYYYYYYYYYYYYaaaaaaaaaaaaaaaaaWWaWWiNNNNNNNNNNNNNNNNNNNNiWWaWWaaaaaaaaaaaaaaaaaaaaaaaaaaaaaaaa
aYYYYYYYYYYYYYYYYYYaaaaaaaaaaaaaaaaaWWaWWiNNNNNNNNNNNNNNNNNNNNiWWaWWaaaaaaaaaaaaaaaaaaaaaaaaaaaaaaaa
aYYYYYYYYYYYYYYYYYYaaaaaaaaaaaaaaaaaWWaWWiNNNNNNNNNNNNNNNNNNNNiWWaWWaaaaaaaaaaaaaaaaaaaaaaaaaaaaaaaa
aaaaaaaaaaaaaaaaaaaaaaaaaaaaaaaaaaaaWWaWWiNNNNNNNNNNNNNNNNNNNNiWWaWWaaaaaaaaaaaaaaaaaaaaaaaaaaaaaaaa
"}
