"a" = (/turf/unsimulated/ground/grass,/area/space)
"b" = (/obj/structure/fence/cut/medium,/turf/unsimulated/ground/grass,/area/space)
"c" = (/obj/structure/fence{dir = 4},/turf/unsimulated/ground/grass,/area/space)
"d" = (/obj/structure/platform{dir = 1},/turf/unsimulated/floor/river/deep{icon_state = "water"},/area/space)
"e" = (/turf/unsimulated/floor/road{dir = 8},/area/space)
"i" = (/turf/unsimulated/floor/road{icon_state = "sidewalkconcrete"},/area/space)
"j" = (/obj/structure/fence{dir = 4},/turf/unsimulated/floor/road{icon_state = "concreteroad"; temperature = 293.15},/area/space)
"k" = (/obj/structure/fence/cut/small,/obj/structure/fence/cut/small,/turf/unsimulated/ground/grass,/area/space)
"l" = (/obj/structure/sandbag/concrete_block{dir = 1},/obj/structure/sandbag/concrete_block{dir = 4},/turf/unsimulated/floor/road{icon_state = "sidewalkconcrete"},/area/space)
"m" = (/obj/structure/sandbag/concrete_block{dir = 4},/turf/unsimulated/floor/road{icon_state = "sidewalkconcrete"},/area/space)
"n" = (/obj/structure/railing{dir = 4},/turf/unsimulated/floor/fakestairs/north{icon_state = "bunkertop"},/area/space)
"p" = (/obj/structure/sandbag/concrete_block,/turf/unsimulated/floor/road{icon_state = "stone3"},/area/space)
"q" = (/obj/structure/holonet,/turf/unsimulated/floor/road{icon_state = "stone3"},/area/space)
"r" = (/turf/unsimulated/floor/road{dir = 8; icon_state = "roaddottedstripescross"},/area/space)
"s" = (/obj/structure/sandbag/concrete_block,/turf/unsimulated/floor/road{icon_state = "sidewalkconcrete"},/area/space)
"u" = (/obj/structure/sandbag/concrete_block{dir = 8},/turf/unsimulated/floor/road{icon_state = "sidewalkconcrete"},/area/space)
"v" = (/obj/effect/floor_decal/road{dir = 1},/turf/unsimulated/floor/road{icon_state = "concreteroad"; temperature = 293.15},/area/space)
"w" = (/turf/unsimulated/floor/road,/area/space)
"x" = (/obj/structure/sandbag/concrete_block,/turf/unsimulated/floor/river/deep{icon_state = "water"},/area/space)
"y" = (/obj/structure/platform,/turf/unsimulated/floor/river/deep{icon_state = "water"},/area/space)
"z" = (/obj/structure/sandbag/concrete_block{dir = 1},/obj/structure/sandbag/concrete_block{dir = 8},/turf/unsimulated/floor/road{icon_state = "sidewalkconcrete"},/area/space)
"B" = (/turf/unsimulated/floor/rescue_base,/area/space)
"C" = (/turf/unsimulated/floor/road{icon_state = "stone3"},/area/space)
"E" = (/obj/structure/fence/door,/turf/unsimulated/floor/road{icon_state = "concreteroad"; temperature = 293.15},/area/space)
"F" = (/obj/structure/fence/door/opened,/turf/unsimulated/ground/grass,/area/space)
"G" = (/obj/structure/fence/corner,/turf/unsimulated/ground/grass,/area/space)
"H" = (/turf/unsimulated/floor/road{icon_state = "sidewalk_corner_road"},/area/space)
"I" = (/turf/unsimulated/floor/road{dir = 4; icon_state = "sidewalk_corner_road"},/area/space)
"J" = (/obj/structure/fence/corner{dir = 8},/turf/unsimulated/ground/grass,/area/space)
"K" = (/turf/unsimulated/floor/road{icon_state = "zebracrossingvert"},/area/space)
"L" = (/obj/structure/sandbag/concrete_block{dir = 8},/obj/structure/sandbag/concrete_block,/turf/unsimulated/floor/road{icon_state = "sidewalkconcrete"},/area/space)
"N" = (/turf/unsimulated/floor/river/deep{icon_state = "water"},/area/space)
"O" = (/obj/structure/fence/cut/small,/turf/unsimulated/ground/grass,/area/space)
"P" = (/obj/structure/sandbag/concrete_block{dir = 4},/obj/structure/sandbag/concrete_block,/turf/unsimulated/floor/road{icon_state = "sidewalkconcrete"},/area/space)
"Q" = (/turf/unsimulated/floor/road{dir = 8; icon_state = "sidewalk_corner_road"},/area/space)
"R" = (/turf/unsimulated/floor/road{dir = 1; icon_state = "sidewalk_corner_road"},/area/space)
"S" = (/obj/structure/fence/door,/turf/unsimulated/ground/grass,/area/space)
"T" = (/obj/structure/fence,/turf/unsimulated/ground/grass,/area/space)
"V" = (/turf/unsimulated/ground/grass,/area/coldwar/warpactfob)
"W" = (/turf/unsimulated/floor/road{icon_state = "concreteroad"; temperature = 293.15},/area/space)
"X" = (/obj/structure/fence/cut/large,/turf/unsimulated/ground/grass,/area/space)
"Y" = (/turf/unsimulated/ground/grass,/area/coldwar/usmcfob)

(1,1,1) = {"
aaaaaaaaaaaaaaaaaaaaaaaaaaaaaaaaaaaaaaaiWWwWWmNNNNNNNNNNNNuWWwWWaaaaaaaaaaaaaaaaaaaaaaaaaaaaaaaaaaaa
aaaaaaaaaaaaaaaaaaaaaaaaaaaaaaaaaaaaaaaiWWwWWmNNNNNNNNNNNNuWWwWWaaaaaaaaaaaaaaaaaaaaaaaaaaaaaaaaaaaa
aaaaaaaaaaaaaaaaaaaaaaaaaaaaaaaaaaaaaaaiWWwWWmNNNNNNNNNNNNuWWwWWaaaaaaaaaaaaaaaaaaaVVVVVVVVVVVVVVVaa
aaaaaaaaaaaaaaaaaaaaaaaaaaaaaaaaaaaaaaaiWWwWWmNNNNNNNNNNNNuWWwWWaaaaaaaaaaaaaaaaaaaVVVVVVVVVVVVVVVaa
aaaaaaaaaaaaaaaaaaaaaaaaaaaaaaaaaaaaaaaiWWwWWmNNNNNNNNNNNNuWWwWWaaaaaaaaaaaaaaaaaaaVVVVVVVVVVVVVVVaa
aaaaaaaaaaaaaaaaaaaaaaaaaaaaaaaaaaaaaaaiWWwWWmNNNNNNNNNNNNuWWwWWaaaaaaaaaaaaaaaaaaaVVVVVVVVVVVVVVVaa
aaaaaaaaaaaaaaaaaaaaaaaaaaaaaaaaaaaaaaaiWWwWWmNNNNNNNNNNNNuWWwWWaaaaaaaaaaaaaaaaaaaVVVVVVVVVVVVVVVaa
aaaaaaaaaaaaaaaaaaaaaaaaaaaaaaaaaaaaaaaiWWwWWmNNNNNNNNNNNNuWWwWWaaaaaaaaaaaaaaaaaaaVVVVVVVVVVVVVVVaa
aaaaaaaaaaaaaaaaaaaaaaaaaaaaaaaaaaaaaaaiWWwWWmNNNNNNNNNNNNuWWwWWaaaaaaaaaaaaaaaaaaaVVVVVVVVVVVVVVVaa
aaaaaaaaaaaaaaaaaaaaaaaaaaaaaaaaaaaaaaaiWWwWWmNNNNNNNNNNNNuWWwWWaaaaaaaaaaaaaaaaaaaVVVVVVVVVVVVVVVaa
aaaaaaaaaaaaaaaaaaaaaaaaaaaaaaaaaaaaaaaiWWwWWmNNNNNNNNNNNNuWWwWWaaaaaaaaaaaaaaaaaaaVVVVVVVVVVVVVVVaa
aaaaaaaaaaaaaaaaaaaaaaaaaaaaaaaaaaaaaaaiWWwWWmNNNNNNNNNNNNuWWwWWaaaaaaaaaaaaaaaaaaaVVVVVVVVVVVVVVVaa
aaaaaaaaaaaaaaaaaaaaaaaaaaaaaaaaaaaaaaaiWWwWWmxxxxxxxxxxxxuWWwWWaaaaaaaaaaaaaaaaaaaVVVVVVVVVVVVVVVaa
aaaaaaaaaaaaaaaaaaaaaaaaaaaaaaaaaaaaaaaiWWwWWQiiiiiiiiiiiiRWWwWWaaaaaaaaaaaaaaaaaaaVVVVVVVVVVVVVVVaa
aaaaaaaaaaaaaaaaaaaaaaaaaaaaaaaaaaaaaaaiWWwWWWWWWWWWWWWWWWWWWwWWaaaaaaaaaaaaaaaaaaaVVVVVVVVVVVVVVVaa
aaaaaaaaaaaaaaaaaaaaaaaaaaaaaaaaaaaaaaaiWWwWWWWWWWWWWWWWWWWWWwWWaaaaaaaaaaaaaaaaaaaVVVVVVVVVVVVVVVaa
aaaaaaaaaaaaaaaaaaaaaaaaaaaaaaaaaaaaaaaieereeeeeeeeeeeeeeeeeerWWaaaaaaaaaaaaaaaaaaaVVVVVVVVVVVVVVVaa
aaaaaaaaaaaaaaaaaaaaaaaaaaaaaaaaaaaaaaaiWWwWWWWWWWWWWWWWWWWWWwWWaaaaaaaaaaaaaaaaaaaaaaaaaaaaaaaaaaaa
aaaaaaaaaaaaaaaaaaaaaaaaaaaaaaaaaaaaaaaiWWwWWWWWWWWWWWWWWWWWWwWWaaaaaaaaaaaaaaaaaaaaaaaaaaaaaaaaaaaa
aaaaaaaaaaaaaaaaaaaaaaaaaaaaaaaaaaaaaaaiWWwWWIssssssssssssHWWwWWaaaaaaaaaaaaaaaaaaaaaaaaaaaaaaaaaaaa
aaaaaaaaaaaaaaaaaaaaaaaaaaaaaaaaaaaaaaaiWWwWWmdddddddddddduWWwWWaaaaaaaaaaaaaaaaaaaaaaaaaaaaaaaaaaaa
aaaaaaaaaaaaaaaaaaaaaaaaaaaaaaaaaaaaaaaiWWwWWmNNNNNNNNNNNNuWWwWWaaaaaaaaaaaaaaaaaaaaaaaaaaaaaaaaaaaa
aaaaaaaaaaaaaaaaaaaaaaaaaaaaaaaaaaaaaaaiWWwWWmNNNNNNNNNNNNuWWwWWaaaaaaaaaaaaaaaaaaaaaaaaaaaaaaaaaaaa
aaaaaaaaaaaaaaaaaaaaaaaaaaaaaaaaaaaaaaaiWWwWWmNNNNNNNNNNNNuWWwWWaaaaaaaaaaaaaaaaaaaaaaaaaaaaaaaaaaaa
aaaaaaaaaaaaaaaaaaaaaaaaaaaaaaaaaaaaaaaiWWwWWmNNNNNNNNNNNNuWWwWWaaaaaaaaaaaaaaaaaaaaaaaaaaaaaaaaaaaa
aaaaaaaaaaaaaaaaaaaaaaaaaaaaaaaaaaaaaaaiWWwWWmNNNNNNNNNNNNuWWwWWaaaaaaaaaaaaaaaaaaaaaaaaaaaaaaaaaaaa
aaaaaaaaaaaaaaaaaaaaaaaaaaaaaaaaaaaaaaaiWWwWWmNNNNNNNNNNNNuWWwWWaaaaaaaaaaaaaaaaaaaaaaaaaaaaaaaaaaaa
aaaaaaaaaaaaaaaaaaaaaaaaaaaaaaaaaaaaaaaiWWwWWmNNNNNNNNNNNNuWWwWWaaaaaaaaaaaaaaaaaaaaaaaaaaaaaaaaaaaa
aaaaaaaaaaaaaaaaaaaaaaaaaaaaaaaaaaaaaaaiWWwWWmNNNNNNNNNNNNuWWwWWaaaaaaaaaaaaaaaaaaaaaaaaaaaaaaaaaaaa
aaaaaaaaaaaaaaaaaaaaaaaaaaaaaaaaaaaaaaaiWWwWWmNNNNNNNNNNNNuWWwWWaaaaaaaaaaaaaaaaaaaaaaaaaaaaaaaaaaaa
aaaaaaaaaaaaaaaaaaaaaaaaaaaaaaaaaaaaaaaiWWwWWmNNNNNNNNNNNNuWWwWWaaaaaaaaaaaaaaaaaaaaaaaaaaaaaaaaaaaa
aaaaaaaaaaaaaaaaaaaaaaaaaaaaaaaaaaaaaaaiWWwWWmNNNNNNNNNNNNuWWwWWaaaaaaaaaaaaaaaaaaaaaaaaaaaaaaaaaaaa
aaaaaaaaaaaaaaaaaaaaaaaaaaaaaaaaaaaaaaaiWWwWWmNNNNNNNNNNNNuWWwWWaaaaaaaaaaaaaaaaaaaaaaaaaaaaaaaaaaaa
aaaaaaaaaaaaaaaaaaaaaaaaaaaaaaaaaaaaaaaiWWwWWmNNNNNNNNNNNNuWWwWWaaaaaaaaaaaaaaaaaaaaaaaaaaaaaaaaaaaa
aaaaaaaaaaaaaaaaaaaaaaaaaaaaaaaaaaaaaaaiWWwWWmNNNNNNNNNNNNuWWwWWaaaaaaaaaaaaaaaaaaaaaaaaaaaaaaaaaaaa
aaaaaaaaaaaaaaaaaaaaaaaaaaaaaaaaaaaaaaaiWWwWWmNNNNNNNNNNNNuWWwWWaaaaaaaaaaaaaaaaaaaaaaaaaaaaaaaaaaaa
aaaaaaaaaaaaaaaaaaaaaaaaaaaaaaaaaaaaaaaiWWwWWmNNNNNNNNNNNNuWWwWWaaaaaaaaaaaaaaaaaaaaaaaaaaaaaaaaaaaa
aaaaaaaaaaaaaaaaaaaaaaaaaaaaaaaaaaaaaaaiWWwWWmNNNNNNNNNNNNuWWwWWaaaaaaaaaaaaaaaaaaaaaaaaaaaaaaaaaaaa
aaaaaaaaaaaaaaaaaaaaaaaaaaaaaaaaaaaaaaaiWWwWWmNNNNNNNNNNNNuWWwWWaaaaaaaaaaaaaaaaaaaaaaaaaaaaaaaaaaaa
aaaaaaaaaaaaaaaaaaaaaaaaaaaaaaaaaaaaaaaiWWwWWmNNNNNNNNNNNNuWWwWWaaaaaaaaaaaaaaaaaaaaaaaaaaaaaaaaaaaa
aaaaaaaaaaaaaaaaaaaaaaaaaaaaaaaaaaaaaaaiWWwWWmBNNNNNNNNNNNuWWwWWaaaaaaaaaaaaaaaaaaaaaaaaaaaaaaaaaaaa
aaaaaaaaaaaaaaaaaaaaaaaaaaaaaaaaaaaaaaaiWWwWWmnNNNNNNNNNNNuWWwWWaaaaaaaaaaaaaaaaaaaaaaaaaaaaaaaaaaaa
aaaaaaaaaaaaaaaaaaaaaaaaaaaaaaaaaaaaaaaiWWwWWiPNNNNNNNNNNNiWWwWWaaaaaaaaaaaaaaaaaaaaaaaaaaaaaaaaaaaa
aaaaaaaaaaaaaaaaaaaaaaaaaaaaaaaaaaaaaaaiWWwWWmNNNNNNNNNNNNuWWwWWaaaaaaaaaaaaaaaaaaaaaaaaaaaaaaaaaaaa
aaaaaaaaaaaaaaaaaaaaaaaaaaaaaaaaaaaaaaaiWWwWWmxxyyNNyxxxxxuWWwWWaaaaaaaaaaaaaaaaaaaaaaaaaaaaaaaaaaaa
aaaaaaaaaaaaaaaaaaaaaaaaaaaaaaaaaaaaaaaiWWwWWiCCCdNNdCCCCCiWWwWWaaaaaaaaaaaaaaaaaaaaaaaaaaaaaaaaaaaa
aaaaaaaaaaaaaaaaaaaaaaaaaaCCCCCCCCCCCCCCKKKKKCCCCCCCCCCCCCCKKKKKCCCaaaaaaaaaaaaaaaaaaaaaaaaaaaaaaaaa
aaaaaaaaaaaaaaaaaaaaaaaaCCCCqCCCCCCCCCCCKKKKKCCCNCCCNCCCNCCKKKKKCCCaaaaaaaaaaaaaaaaaaaaaaaaaaaaaaaaa
aaaaaaaaaaaaaaaaaaaaaaaCCCCaaaaaaaaaaaaiWWwWWipyNNNNNyppppiWWwWWaaaaaaaaaaaaaaaaaaaaaaaaaaaaaaaaaaaa
aaaaaaaaaaaaaaaaaaaaaaCCCaaaaaaaaaaaaaaiWWwWWmddNNNNNddddduWWwWWaaaaaaaaaaaaaaaaaaaaaaaaaaaaaaaaaaaa
aaaaaaaaaaaaaaaaaaaaaaCCaaaaaaaaaaaaaaaiWWwWWmNNNNNNNNNNNNuWWwWWaaaaaaaaaaaaaaaaaaaaaaaaaaaaaaaaaaaa
aaaaaaaaaaaaaaaaaaaaaCCCaaaaaaaaaaaaaaaiWWwWWmNNNNNNNNNNNNuWWwWWaaaaaaaaaaaaaaaaaaaaaaaaaaaaaaaaaaaa
aaaaaaaaaaaaaaaaaaaaaCCaaaaaaaaaaaaaaaaiWWwWWmNNNNNNNNNNNNuWWwWWaaaaaaaaaaaaaaaaaaaaaaaaaaaaaaaaaaaa
aaaaaaaaaaaaaaaaaaaaaCCaaaaaaaaaaaaaaaaiWWwWWmNNNNNNNNNNNNuWWwWWaaaaaaaaaaaaaaaaaaaaaaaaaaaaaaaaaaaa
aaaaaaaaaaaaaaaaaaaaaCCaaaaaaaaaaaaaaaaiWWwWWmNNNNNNNNNNNNuWWwWWaaaaaaaaaaaaaaaaaaaaaaaaaaaaaaaaaaaa
aaaaaaaaaaaaaaaaaaaaaCCaaaaaaaaaaaaaaaaiWWwWWmNNNNNNNNNNNNuWWwWWaaaaaaaaaaaaaaaaaaaaaaaaaaaaaaaaaaaa
aaaaaaaaaaaaaaaaaaaaaCCaaaaaaaaaaaaaaaaiWWwWWmNNNNNNNNNNNNuWWwWWaaaaaaaaaaaaaaaaaaaaaaaaaaaaaaaaaaaa
aaaaaaaaaaaaaaaaaaaaaaaaaaaaaaaaaaaaaaaiWWwWWmNNNNNNNNNNNNuWWwWWaaaaaaaaaaaaaaaaaaaaaaaaaaaaaaaaaaaa
aaaaaaaaaaaaaaaaaaaaaaaaaaaaaaaaaaaaaaaiWWwWWmNNNNNNNNNNNNuWWwWWaaaaaaaaaaaaaaaaaaaaaaaaaaaaaaaaaaaa
aaaaaaaaaaaaaaaaaaaaaaaaaaaaaaaaaaaaaaaiWWwWWmNNNNNNNNNNNNuWWwWWaaaaaaaaaaaaaaaaaaaaaaaaaaaaaaaaaaaa
aaaaaaaaaaaaaaaaaaaaaaaaaaaaaaaaaaaaaaaiWWwWWmNNNNNNNNNNNNuWWwWWaaaaaaaaaaaaaaaaaaaaaaaaaaaaaaaaaaaa
aaaaaaaaaaaaaaaaaaaaaaaaaaaaaaaaaaaaaaaiWWwWWmNNNNNNNNNNNNuWWwWWaaaaaaaaaaaaaaaaaaaaaaaaaaaaaaaaaaaa
aaaaaaaaaaaaaaaaaaaaaaaaaaaaaaaaaaaaaaaiWWwWWmNNNNNNNNNNNNuWWwWWaaaaaaaaaaaaaaaaaaaaaaaaaaaaaaaaaaaa
aaaaaaaaaaaaaaaaaaaaaaaaaaaaaaaaaaaaaaaiWWwWWilNNNNNNNNNNziWWwWWaaaaaaaaaaaaaaaaaaaaaaaaaaaaaaaaaaaa
aaJcccFScccGaaaaaaaaaaaaaaaaaaaaaaaaaaaiWWwWWimNNNNNNNNNNuiWWwWWaaaaaaaaaaaaaaaaaaaaaaaaaaaaaaaaaaaa
aaTWWWWWWWWTaaaaaaaaaaaaaaaaaaaaaaaaaaaiWWwWWiPNNNNNNNNNNLiWWwWWaaaaaaaaaaaaaaaaaaaaaaaaaaaaaaaaaaaa
aaTWWWWWWWWTaaaaaaaaaaaaaaaaaaaaaaaaaaaiWWwWWmNNNNNNNNNNNNuWWwWWaaaaaaaaaaaaaaaaaaaaaaaaaaaaaaaaaaaa
aaTWWWWWWWWTaaaaaaaaaaaaaaaaaaaaaaaaaaaiWWwWWmNNNNNNNNNNNNuWWwWWaaaaaaaaaaaaaaaaaaaaaaaaaaaaaaaaaaaa
aaOWWWWWWWWTaaaaaaaaaaaaaaaaaaaaaaaaaaaiWWwWWmNNNNNNNNNNNNuWWwWWaaaaaaaaaaaaaaaaaaaaaaaaaaaaaaaaaaaa
aaOWWWWWWWWXaaaaaaaaaaaaaaaaaaaaaaaaaaaiWWwWWmNNNNNNNNNNNNuWWwWWaaaaaaaaaaaaaaaaaaaaaaaaaaaaaaaaaaaa
aakWWWWWWWWbaaaaaaaaaaaaaaaaaaaaaaaaaaaiWWwWWmNNNNNNNNNNNNuWWwWWaaaaaaaaaaaaaaaaaaaaaaaaaaaaaaaaaaaa
aaTWWWWWWWWTaaaaaaaaaaaaaaaaaaaaaaaaaaaiWWwWWmNNNNNNNNNNNNuWWwWWaaaaaaaaaaaaaaaaaaaaaaaaaaaaaaaaaaaa
aaTWWWWWWWWTaaaaaaaaaaaaaaaaaaaaaaaaaaaiWWwWWmNNNNNNNNNNNNuWWwWWaaaaaaaaaaaaaaaaaaaaaaaaaaaaaaaaaaaa
aaTWWWWWWWWTaaaaaaaaaaaaaaaaaaaaaaaaaaaiWWwWWmNNNNNNNNNNNNuWWwWWaaaaaaaaaaaaaaaaaaaaaaaaaaaaaaaaaaaa
aaTWWWWWWWWTaaaaaaaaaaaaaaaaaaaaaaaaaaaiWWwWWmNNNNNNNNNNNNuWWwWWaaaaaaaaaaaaaaaaaaaaaaaaaaaaaaaaaaaa
aaJjjjEEjjjGaaaaaaaaaaaaaaaaaaaaaaaaaaaiWWwWWmNNNNNNNNNNNNuWWwWWaaaaaaaaaaaaaaaaaaaaaaaaaaaaaaaaaaaa
aaaaaaaaaaaaaaaaaaaaaaaaaaaaaaaaaaaaaaaiWWwWWmNNNNNNNNNNNNuWWwWWaaaaaaaaaaaaaaaaaaaaaaaaaaaaaaaaaaaa
aaaaaaaaaaaaaaaaaaaaaaaaaaaaaaaaaaaaaaaiWWwWWmNNNNNNNNNNNNuWWwWWaaaaaaaaaaaaaaaaaaaaaaaaaaaaaaaaaaaa
aaaaaaaaaaaaaaaaaaaaaaaaaaaaaaaaaaaaaaaiWWwWWmNNNNNNNNNNNNuWWwWWaaaaaaaaaaaaaaaaaaaaaaaaaaaaaaaaaaaa
aaaaaaaaaaaaaaaaaaaaaaaaaaaaaaaaaaaaaaaiWWwWWmxxxxxxxxxxxxuWWwWWaaaaaaaaaaaaaaaaaaaaaaaaaaaaaaaaaaaa
aaaaaaaaaaaaaaaaaaaaaaaaaaaaaaaaaaaaaaiRWWwWWQiiiiiiiiiiiiRWWwWWaaaaaaaaaaaaaaaaaaaaaaaaaaaaaaaaaaaa
aaaaaaaaaaaaaaaaaaaaaaaaaaaaaaaaaaaaaaWWWWwWWWvvvvvvvvvvvvWWWwWWaaaaaaaaaaaaaaaaaaaaaaaaaaaaaaaaaaaa
aaaaaaaaaaaaaaaaaaaaaaaaaaaaaaaaaaaaaaWWWWwWWWWWWWWWWWWWWWWWWwWWaaaaaaaaaaaaaaaaaaaaaaaaaaaaaaaaaaaa
aYYYYYYYYYYYYYYYYYYaaaaaaaaaaaaaaaaaaaeeeereeeeeeeeeeeeeeeeeereeaaaaaaaaaaaaaaaaaaaaaaaaaaaaaaaaaaaa
aYYYYYYYYYYYYYYYYYYaaaaaaaaaaaaaaaaaaaWWWWwWWWWWWWWWWWWWWWWWWwWWaaaaaaaaaaaaaaaaaaaaaaaaaaaaaaaaaaaa
aYYYYYYYYYYYYYYYYYYaaaaaaaaaaaaaaaaaaaWWWWwWWWWWWWWWWWWWWWWWWwWWaaaaaaaaaaaaaaaaaaaaaaaaaaaaaaaaaaaa
aYYYYYYYYYYYYYYYYYYaaaaaaaaaaaaaaaaaaaiHWWwWWIssssssssssssHWWwWWaaaaaaaaaaaaaaaaaaaaaaaaaaaaaaaaaaaa
aYYYYYYYYYYYYYYYYYYaaaaaaaaaaaaaaaaaaaaiWWwWWmdddddddddddduWWwWWaaaaaaaaaaaaaaaaaaaaaaaaaaaaaaaaaaaa
aYYYYYYYYYYYYYYYYYYaaaaaaaaaaaaaaaaaaaaaWWwWWmNNNNNNNNNNNNuWWwWWaaaaaaaaaaaaaaaaaaaaaaaaaaaaaaaaaaaa
aYYYYYYYYYYYYYYYYYYaaaaaaaaaaaaaaaaaaaaaWWwWWmNNNNNNNNNNNNuWWwWWaaaaaaaaaaaaaaaaaaaaaaaaaaaaaaaaaaaa
aYYYYYYYYYYYYYYYYYYaaaaaaaaaaaaaaaaaaaaaWWwWWmNNNNNNNNNNNNuWWwWWaaaaaaaaaaaaaaaaaaaaaaaaaaaaaaaaaaaa
aYYYYYYYYYYYYYYYYYYaaaaaaaaaaaaaaaaaaaaaWWwWWmNNNNNNNNNNNNuWWwWWaaaaaaaaaaaaaaaaaaaaaaaaaaaaaaaaaaaa
aYYYYYYYYYYYYYYYYYYaaaaaaaaaaaaaaaaaaaaaWWwWWmNNNNNNNNNNNNuWWwWWaaaaaaaaaaaaaaaaaaaaaaaaaaaaaaaaaaaa
aYYYYYYYYYYYYYYYYYYaaaaaaaaaaaaaaaaaaaaaWWwWWmNNNNNNNNNNNNuWWwWWaaaaaaaaaaaaaaaaaaaaaaaaaaaaaaaaaaaa
aYYYYYYYYYYYYYYYYYYaaaaaaaaaaaaaaaaaaaaaWWwWWmNNNNNNNNNNNNuWWwWWaaaaaaaaaaaaaaaaaaaaaaaaaaaaaaaaaaaa
aYYYYYYYYYYYYYYYYYYaaaaaaaaaaaaaaaaaaaaaWWwWWmNNNNNNNNNNNNuWWwWWaaaaaaaaaaaaaaaaaaaaaaaaaaaaaaaaaaaa
aYYYYYYYYYYYYYYYYYYaaaaaaaaaaaaaaaaaaaaaWWwWWmNNNNNNNNNNNNuWWwWWaaaaaaaaaaaaaaaaaaaaaaaaaaaaaaaaaaaa
aYYYYYYYYYYYYYYYYYYaaaaaaaaaaaaaaaaaaaaaWWwWWmNNNNNNNNNNNNuWWwWWaaaaaaaaaaaaaaaaaaaaaaaaaaaaaaaaaaaa
aYYYYYYYYYYYYYYYYYYaaaaaaaaaaaaaaaaaaaaaWWwWWmNNNNNNNNNNNNuWWwWWaaaaaaaaaaaaaaaaaaaaaaaaaaaaaaaaaaaa
aaaaaaaaaaaaaaaaaaaaaaaaaaaaaaaaaaaaaaaaWWwWWmNNNNNNNNNNNNuWWwWWaaaaaaaaaaaaaaaaaaaaaaaaaaaaaaaaaaaa
"}
